C 225,30,0
1111111111111111111111111
1000000000110000000000001
1011000001110000002000001
1001000000000000000000001