R 444 44489789
NO textures/eagle.xpm
SO textures/colorstone.xpm
WE textures/redbrick.xpm
EA textures/eagle.xpm
S textures/barrel.xpm
F 1,254,0
C 254,1,1

1111111111111111111111111111
1000000000000000000000000001
1000000000000000200000000001
1000000000000000200000000001
1000000000000000200000000001
1000000000000000000000000001
1000000000000000000000000001
1111111111111111111111111111




1111111111111111111111111111
1000000000000000000000000001
1000000000000000000N00000001
1000000000000000000000000001        
1000000000000000000000000001                
1000000000000000000000000001            
1111111111111111111111111111
