R 600 400
NO textures/eagle.xpm
SO textures/colorstone.xpm
WE textures/redbrick.xpm


EA textures/eagle.xpm
S textures/barrel.xpm
F 0,255,0
C 255,0,0

1111111111111111111111111111
1000000000000000000000000001
1000000000000000200000000001
1000000000000000200000000001
1000000000000000200000000001
1000000000000000000000000001
1000000000000000000000000001
1000022222222222222222222001
1000000000000000000N00000001
1000000000000000000000000001
1000000000000000000000000001
1000000000000000000001111111
1000000000000020000001000001
1000000000000000000001000001
1000000000000000000001000001
1111111111111111111111111111
